.dw %0000000000000000 %0000000000000000 %0000000000000000 %0000000000000000 %0000000000000000 %0000000000000000 %0000000000000000 %0000000000000000
.dw %0000000000000000 %0000000000000000 %0000000000000000 %0000000000000000 %0000000000000000 %0000000000000000 %0000000000000000 %0000000000000000
.dw %0000000000000000 %0000000000000000 %0000000000000000 %0000000000000000 %0000000000000000 %0000000000000000 %0000000000000000 %0000000000000000
.dw %0000000000000000 %0000000000000000 %0000000000000000 %0000000000000000 %0000000000000000 %0000000000000000 %0000000000000000 %0000000000000000

.dw %0000000000000000 %0000000000000000 %0000000000000000 %0000000000000000 %0000000000000000 %0000000000000000 %0000000000000000 %0000000000000000
.dw %0000000000000000 %0000000000000000 %0000000000000000 %0000000000000000 %0000000000000000 %0000000000000000 %0000000000000000 %0000000000000000
.dw %0000000000000000 %0000000000000000 %0000000000000000 %0000000000000000 %0000000000000000 %0000000000000000 %0000000000000000 %0000000000000000
.dw %0000000000000000 %0000000000000000 %0000000000000000 %0000000000000000 %0000000000000000 %0000000000000000 %0000000000000000 %0000000000000000

.dw %0000000000000000 %0000000000000000 %0000000000000000 %0000000000000000 %0000000000000000 %0000000000000000 %0000000000000000 %0000000000000000
.dw %0000000000000000 %0000000000000000 %0000000000000000 %0000000000000000 %0000000000000000 %0000000000000000 %0000000000000000 %0000000000000000
.dw %0000000000000000 %0000000000000000 %0000000000000000 %0000000000000000 %0000000000000000 %0000000000000000 %0000000000000000 %0000000000000000
.dw %0000000000000000 %0000000000000000 %0000000000000000 %0000000000000000 %0000000000000000 %0000000000000000 %0000000000000000 %0000000000000000

.dw %0000000000000000 %0000000000000000 %0000000000000000 %0000000000000000 %0000000000000000 %0000000000000000 %0000000000000000 %0000000000000000
.dw %0000000000000000 %0000000000000000 %0000000000000000 %0000000000000000 %0000000000000000 %0000000000000000 %0000000000000000 %0000000000000000
.dw %0000000000000000 %0000000000000000 %0000000000000000 %0000000000000000 %0000000000000000 %0000000000000000 %0000000000000000 %0000000000000000
.dw %0000000000000000 %0000000000000000 %0000000000000000 %0000000000000000 %0000000000000000 %0000000000000000 %0000000000000000 %0000000000000000

.dw %0000000000000000 %0000000000000000 %0000000000000000 %0000000000000000 %0000000000000000 %0000000000000000 %0000000000000000 %0000000000000000
.dw %0000000000000000 %0000000000000000 %0000000000000000 %0000000000000000 %0000000000000000 %0000000000000000 %0000000000000000 %0000000000000000
.dw %0000000000000000 %0000000000000000 %0000000000000000 %0000000000000000 %0000000000000000 %0000000000000000 %0000000000000000 %0000000000000000
.dw %0000000000000000 %0000000000000000 %0000000000000000 %0000000000000000 %0000000000000000 %0000000000000000 %0000000000000000 %0000000000000000

.dw %0000000000000000 %0000000000000000 %0000000000000000 %0000000000000000 %0000000000000000 %0000000000000000 %0000000000000000 %0000000000000000
.dw %0000000000000000 %0000000000000000 %0000000000000000 %0000000000000000 %0000000000000000 %0000000000000000 %0000000000000000 %0000000000000000
.dw %0000000000000000 %0000000000000000 %0000000000000000 %0000000000000000 %0000000000000000 %0000000000000000 %0000000000000000 %0000000000000000
.dw %0000000000000000 %0000000000000000 %0000000000000000 %0000000000000000 %0000000000000000 %0000000000000000 %0000000000000000 %0000000000000000

.dw %0000000000000000 %0000000000000000 %0000000000000000 %0000000000000000 %0000000000000000 %0000000000000000 %0000000000000000 %0000000000000000
.dw %0000000000000000 %0000000000000000 %0000000000000000 %0000000000000000 %0000000000000000 %0000000000000000 %0000000000000000 %0000000000000000
.dw %0000000000000000 %0000000000000000 %0000000000000000 %0000000000000000 %0000000000000000 %0000000000000000 %0000000000000000 %0000000000000000
.dw %0000000000000000 %0000000000000000 %0000000000000000 %0000000000000000 %0000000000000000 %0000000000000000 %0000000000000000 %0000000000000000

.dw %0000000000000000 %0000000000000000 %0000000000000000 %0000000000000000 %0000000000000000 %0000000000000000 %0000000000000000 %0000000000000000
.dw %0000000000000000 %0000000000000000 %0000000000000000 %0000000000000000 %0000000000000000 %0000000000000000 %0000000000000000 %0000000000000000
.dw %0000000000000000 %0000000000000000 %0000000000000000 %0000000000000000 %0000000000000000 %0000000000000000 %0000000000000000 %0000000000000000
.dw %0000000000000000 %0000000000000000 %0000000000000000 %0000000000000000 %0000000000000000 %0000000000000000 %0000000000000000 %0000000000000000

.dw %0000000000000000 %0000000000000000 %0000000000000000 %0000000000000000 %0000000000000000 %0000000000000000 %0000000000000000 %0000000000000000
.dw %0000000000000000 %0000000000000000 %0000000000000000 %0000000000000000 %0000000000000001 %0000000000000010 %0000000000000101 %0000000000000110
.dw %0000000000001001 %0000000000001010 %0000000000001101 %0000000000001110 %0000000000000000 %0000000000000000 %0000000000000000 %0000000000000000
.dw %0000000000000000 %0000000000000000 %0000000000000000 %0000000000000000 %0000000000000000 %0000000000000000 %0000000000000000 %0000000000000000

.dw %0000000000000000 %0000000000000000 %0000000000000000 %0000000000000000 %0000000000000000 %0000000000000000 %0000000000000000 %0000000000000000
.dw %0000000000000000 %0000000000000000 %0000000000000000 %0000000000000000 %0000000000000011 %0000000000000100 %0000000000000111 %0000000000001000
.dw %0000000000001011 %0000000000001100 %0000000000001111 %0000000000010000 %0000000000000000 %0000000000000000 %0000000000000000 %0000000000000000
.dw %0000000000000000 %0000000000000000 %0000000000000000 %0000000000000000 %0000000000000000 %0000000000000000 %0000000000000000 %0000000000000000

.dw %0000000000000000 %0000000000000000 %0000000000000000 %0000000000000000 %0000000000000000 %0000000000000000 %0000000000000000 %0000000000000000
.dw %0000000000000000 %0000000000000000 %0000000000000000 %0000000000000000 %0000000000000000 %0000000000000000 %0000000000000000 %0000000000000000
.dw %0000000000000000 %0000000000000000 %0000000000000000 %0000000000000000 %0000000000000000 %0000000000000000 %0000000000000000 %0000000000000000
.dw %0000000000000000 %0000000000000000 %0000000000000000 %0000000000000000 %0000000000000000 %0000000000000000 %0000000000000000 %0000000000000000

.dw %0000000000000000 %0000000000000000 %0000000000000000 %0000000000000000 %0000000000000000 %0000000000000000 %0000000000000000 %0000000000000000
.dw %0000000000000000 %0000000000000000 %0000000000000000 %0000000000000000 %0000000000000000 %0000000000000000 %0000000000000000 %0000000000000000
.dw %0000000000000000 %0000000000000000 %0000000000000000 %0000000000000000 %0000000000000000 %0000000000000000 %0000000000000000 %0000000000000000
.dw %0000000000000000 %0000000000000000 %0000000000000000 %0000000000000000 %0000000000000000 %0000000000000000 %0000000000000000 %0000000000000000

.dw %0000000000000000 %0000000000000000 %0000000000000000 %0000000000000000 %0000000000000000 %0000000000000000 %0000000000000000 %0000000000000000
.dw %0000000000000000 %0000000000000000 %0000000000000000 %0000100000010001 %0000100000010010 %0000100000010011 %0000100000010100 %0000100000010101
.dw %0000100000010110 %0000100000010111 %0000100000011000 %0000100000011001 %0000100000011010 %0000000000000000 %0000000000000000 %0000000000000000
.dw %0000000000000000 %0000000000000000 %0000000000000000 %0000000000000000 %0000000000000000 %0000000000000000 %0000000000000000 %0000000000000000

.dw %0000000000000000 %0000000000000000 %0000000000000000 %0000000000000000 %0000000000000000 %0000000000000000 %0000000000000000 %0000000000000000
.dw %0000000000000000 %0000000000000000 %0000000000000000 %0000100000011011 %0000100000011100 %0000100000011101 %0000100000011110 %0000100000011111
.dw %0000100000100000 %0000100000100001 %0000100000100010 %0000100000100011 %0000100000100100 %0000000000000000 %0000000000000000 %0000000000000000
.dw %0000000000000000 %0000000000000000 %0000000000000000 %0000000000000000 %0000000000000000 %0000000000000000 %0000000000000000 %0000000000000000

.dw %0000000000000000 %0000000000000000 %0000000000000000 %0000000000000000 %0000000000000000 %0000000000000000 %0000000000000000 %0000000000000000
.dw %0000000000000000 %0000000000000000 %0000000000000000 %0000100000100101 %0000100000100110 %0000100000100111 %0000100000101000 %0000100000101001
.dw %0000100000101010 %0000100000101011 %0000100000101100 %0000100000101101 %0000100000101110 %0000000000000000 %0000000000000000 %0000000000000000
.dw %0000000000000000 %0000000000000000 %0000000000000000 %0000000000000000 %0000000000000000 %0000000000000000 %0000000000000000 %0000000000000000

.dw %0000000000000000 %0000000000000000 %0000000000000000 %0000000000000000 %0000000000000000 %0000000000000000 %0000000000000000 %0000000000000000
.dw %0000000000000000 %0000000000000000 %0000000000000000 %0000000000000000 %0000000000000000 %0000000000000000 %0000000000000000 %0000000000000000
.dw %0000000000000000 %0000000000000000 %0000000000000000 %0000000000000000 %0000000000000000 %0000000000000000 %0000000000000000 %0000000000000000
.dw %0000000000000000 %0000000000000000 %0000000000000000 %0000000000000000 %0000000000000000 %0000000000000000 %0000000000000000 %0000000000000000

.dw %0000000000000000 %0000000000000000 %0000000000000000 %0000000000000000 %0000000000000000 %0000000000000000 %0000000000000000 %0000000000000000
.dw %0000000000000000 %0000000000000000 %0000000000000000 %0000000000000000 %0000000000000000 %0000000000000000 %0000000000000000 %0000000000000000
.dw %0000000000000000 %0000000000000000 %0000000000000000 %0000000000000000 %0000000000000000 %0000000000000000 %0000000000000000 %0000000000000000
.dw %0000000000000000 %0000000000000000 %0000000000000000 %0000000000000000 %0000000000000000 %0000000000000000 %0000000000000000 %0000000000000000

.dw %0000000000000000 %0000000000000000 %0000000000000000 %0000000000000000 %0000000000000000 %0000000000000000 %0000000000000000 %0000000000000000
.dw %0000000000000000 %0000000000000000 %0000000000000000 %0000000000000000 %0000000000000000 %0000000000000000 %0000000000000000 %0000000000000000
.dw %0000000000000000 %0000000000000000 %0000000000000000 %0000000000000000 %0000000000000000 %0000000000000000 %0000000000000000 %0000000000000000
.dw %0000000000000000 %0000000000000000 %0000000000000000 %0000000000000000 %0000000000000000 %0000000000000000 %0000000000000000 %0000000000000000

.dw %0000000000000000 %0000000000000000 %0000000000000000 %0000000000000000 %0000000000000000 %0000000000000000 %0000000000000000 %0000000000000000
.dw %0000000000000000 %0000000000000000 %0000000000000000 %0000000000000000 %0000000000000000 %0000000000000000 %0000000000000000 %0000000000000000
.dw %0000000000000000 %0000000000000000 %0000000000000000 %0000000000000000 %0000000000000000 %0000000000000000 %0000000000000000 %0000000000000000
.dw %0000000000000000 %0000000000000000 %0000000000000000 %0000000000000000 %0000000000000000 %0000000000000000 %0000000000000000 %0000000000000000

.dw %0000000000000000 %0000000000000000 %0000000000000000 %0000000000000000 %0000000000000000 %0000000000000000 %0000000000000000 %0000000000000000
.dw %0000000000000000 %0000000000000000 %0000000000000000 %0000000000000000 %0000000000000000 %0000000000000000 %0000000000000000 %0000000000000000
.dw %0000000000000000 %0000000000000000 %0000000000000000 %0000000000000000 %0000000000000000 %0000000000000000 %0000000000000000 %0000000000000000
.dw %0000000000000000 %0000000000000000 %0000000000000000 %0000000000000000 %0000000000000000 %0000000000000000 %0000000000000000 %0000000000000000

.dw %0000000000000000 %0000000000000000 %0000000000000000 %0000000000000000 %0000000000000000 %0000000000000000 %0000000000000000 %0000000000000000
.dw %0000000000000000 %0000000000000000 %0000000000000000 %0000000000000000 %0000000000000000 %0000000000000000 %0000000000000000 %0000000000000000
.dw %0000000000000000 %0000000000000000 %0000000000000000 %0000000000000000 %0000000000000000 %0000000000000000 %0000000000000000 %0000000000000000
.dw %0000000000000000 %0000000000000000 %0000000000000000 %0000000000000000 %0000000000000000 %0000000000000000 %0000000000000000 %0000000000000000

.dw %0000000000000000 %0000000000000000 %0000000000000000 %0000000000000000 %0000000000000000 %0000000000000000 %0000000000000000 %0000000000000000
.dw %0000000000000000 %0000000000000000 %0000000000000000 %0000000000000000 %0000000000000000 %0000000000000000 %0000000000000000 %0000000000000000
.dw %0000000000000000 %0000000000000000 %0000000000000000 %0000000000000000 %0000000000000000 %0000000000000000 %0000000000000000 %0000000000000000
.dw %0000000000000000 %0000000000000000 %0000000000000000 %0000000000000000 %0000000000000000 %0000000000000000 %0000000000000000 %0000000000000000

.dw %0000000000000000 %0000000000000000 %0000000000000000 %0000000000000000 %0000000000000000 %0000000000000000 %0000000000000000 %0000000000000000
.dw %0000000000000000 %0000000000000000 %0000000000000000 %0000000000000000 %0000000000000000 %0000000000000000 %0000000000000000 %0000000000000000
.dw %0000000000000000 %0000000000000000 %0000000000000000 %0000000000000000 %0000000000000000 %0000000000000000 %0000000000000000 %0000000000000000
.dw %0000000000000000 %0000000000000000 %0000000000000000 %0000000000000000 %0000000000000000 %0000000000000000 %0000000000000000 %0000000000000000

.dw %0000000000000000 %0000000000000000 %0000000000000000 %0000000000000000 %0000000000000000 %0000000000000000 %0000000000000000 %0000000000000000
.dw %0000000000000000 %0000000000000000 %0000000000000000 %0000000000000000 %0000000000000000 %0000000000000000 %0000000000000000 %0000000000000000
.dw %0000000000000000 %0000000000000000 %0000000000000000 %0000000000000000 %0000000000000000 %0000000000000000 %0000000000000000 %0000000000000000
.dw %0000000000000000 %0000000000000000 %0000000000000000 %0000000000000000 %0000000000000000 %0000000000000000 %0000000000000000 %0000000000000000
